#########
#     # G
# ### # #
#   #   #
#S###### 
#########